incongruous: (adj.) unusual or different from what is around or from what is generally happening
belittle: (v.) to make somebody or the things that somebody does seem unimportant
appease: (v.) to make somebody calmer or less angry by giving them what they want
instigate: (v.) to bring about or initiate an action or event
sage: (adj./n.) wise, especially because you have a lot of experience, or the wise old people
predecessor: (n.) someone who had a job or a position before someone else, or something that comes before another thing in time or in a series
jeoprady: (n.)danger
tangible: (adj.) real and not imaginary; able to be seen, touched or experienced
pivotal: (adj.) central and important
intrinsic: (adj.) part of the essential nature of something; inherent
scrupulous: (adj.)careful about paying attention to every detail;careful to be honest and do what is right
stoic: (adj.) determined not to complain or show your feelings, especially when something bad happens to you
periphery: (n.) the outer edge of an area; the less important part of something, for example of a particular avtivity or of a social or political group
apocryphal: (adj.) (of a story)well known, but probably not true
virtuoso: (n.) a person who is extremely skillful at doing something, especially playing a musical instrument
slander: (v.) to damage someone's reputation by making a false spoken statment about them
animosity: (n.) a strong feeling of opposition, anger or hatred
deplete: (v.) to reduce something by a large amount so that there is not enough left
construe: (v.) to understand the meaning, especially of other people's actions and statements, in a particular way
auspicious: (adj.) showing signs that something is likely to be successful in the future
fickle: (adj.) changing often and suddenly; (of a person) often changing their mind in an unreasonable way so that you cannot rely on them
lethargy: (n.) the state of not having any energy or enthusiasm for doing things
desecrate: (v.) to damage or show no respect towards something holy or very much respected
fortuitous: (adj.) (of something that is to your advantage) not planned, happening by chance
assuage: (v.) to make an unpleasant feelings less severe
prodigious: (adj.) extremely greate in ability, amount, or strength
furtive: (adj.)(disapproving)behaving in a way that shows that you want to keep something secret and do not want to be noticed
supercilious: (adj.) behaving towards other people as if you think you are better than they are
prudent: (adj.) careful and avoiding risks
verbose: (adj.) using or containing more words than are needed